# Notes:
# * If your editor displays this file without line breaks, it may be
#   misintepreting the file format (unix line endings). Please try
#   another editor to avoid confusion.
# * This output represents ONE correct action sequence for the
#   corresponding input. Your program is allowed to find any
#   correct sequence, it does not have to find this same one.
MOVE 1 from (1, 4) to (2, 4).
MOVE 1 from (2, 4) to (3, 4).
MOVE 1 from (3, 4) to (3, 5).
BOOM at (3, 5).

# +-----+-----+-----+-----+-----+-----+-----+-----+
# |     |     |     |     |     |     |     |     |
# | 0,7 | 1,7 | 2,7 | 3,7 | 4,7 | 5,7 | 6,7 | 7,7 |
# +-----+-----+-----+-----+-----+-----+-----+-----+
# |     |     |     |     | ⚫️1 |     |     |     |
# | 0,6 | 1,6 | 2,6 | 3,6 | 4,6 | 5,6 | 6,6 | 7,6 |
# +-----+-----+-----+-----+-----+-----+-----+-----+
# |     |     |     |     |     |     |     |     |
# | 0,5 | 1,5 | 2,5 | 3,5 | 4,5 | 5,5 | 6,5 | 7,5 |
# +-----+-----+-----+-----+-----+-----+-----+-----+
# |     | ⚪️1 |     |     |     |     |     |     |
# | 0,4 | 1,4 | 2,4 | 3,4 | 4,4 | 5,4 | 6,4 | 7,4 |
# +-----+-----+-----+-----+-----+-----+-----+-----+
# |     |     |     |     |     |     |     |     |
# | 0,3 | 1,3 | 2,3 | 3,3 | 4,3 | 5,3 | 6,3 | 7,3 |
# +-----+-----+-----+-----+-----+-----+-----+-----+
# |     |     |     |     |     |     |     |     |
# | 0,2 | 1,2 | 2,2 | 3,2 | 4,2 | 5,2 | 6,2 | 7,2 |
# +-----+-----+-----+-----+-----+-----+-----+-----+
# |     |     |     |     |     |     |     |     |
# | 0,1 | 1,1 | 2,1 | 3,1 | 4,1 | 5,1 | 6,1 | 7,1 |
# +-----+-----+-----+-----+-----+-----+-----+-----+
# |     |     |     |     |     |     |     |     |
# | 0,0 | 1,0 | 2,0 | 3,0 | 4,0 | 5,0 | 6,0 | 7,0 |
# +-----+-----+-----+-----+-----+-----+-----+-----+
